amino_acid_change	amino_acid_change_reverse	Impact
AR	RA	High
AN	NA	High
AD	DA	High
AC	CA	High
AQ	QA	High
AE	EA	High
AG	GA	High
AH	HA	High
AI	IA	High
AL	LA	High
AK	KA	High
AM	MA	High
AF	FA	High
AP	PA	High
AS	SA	Moderate
AT	TA	High
AW	WA	High
AY	YA	High
AV	VA	High
RN	NR	High
RD	DR	High
RC	CR	High
RQ	QR	Moderate
RE	ER	High
RG	GR	High
RH	HR	High
RI	IR	High
RL	LR	High
RK	KR	Moderate
RM	MR	High
RF	FR	High
RP	PR	High
RS	SR	High
RT	TR	High
RW	WR	High
RY	YR	High
RV	VR	High
ND	DN	Moderate
NC	CN	High
NQ	QN	High
NE	EN	High
NG	GN	High
NH	HN	Moderate
NI	IN	High
NL	LN	High
NK	KN	High
NM	MN	High
NF	FN	High
NP	PN	High
NS	SN	Moderate
NT	TN	High
NW	WN	High
NY	YN	High
NV	VN	High
DC	CD	High
DQ	QD	High
DE	ED	Moderate
DG	GD	High
DH	HD	High
DI	ID	High
DL	LD	High
DK	KD	High
DM	MD	High
DF	FD	High
DP	PD	High
DS	SD	High
DT	TD	High
DW	WD	High
DY	YD	High
DV	VD	High
CQ	QC	High
CE	EC	High
CG	GC	High
CH	HC	High
CI	IC	High
CL	LC	High
CK	KC	High
CM	MC	High
CF	FC	High
CP	PC	High
CS	SC	High
CT	TC	High
CW	WC	High
CY	YC	High
CV	VC	High
QE	EQ	Moderate
QG	GQ	High
QH	HQ	High
QI	IQ	High
QL	LQ	High
QK	KQ	Moderate
QM	MQ	High
QF	FQ	High
QP	PQ	High
QS	SQ	High
QT	TQ	High
QW	WQ	High
QY	YQ	High
QV	VQ	High
EG	GE	High
EH	HE	High
EI	IE	High
EL	LE	High
EK	KE	Moderate
EM	ME	High
EF	FE	High
EP	PE	High
ES	SE	High
ET	TE	High
EW	WE	High
EY	YE	High
EV	VE	High
GH	HG	High
GI	IG	High
GL	LG	High
GK	KG	High
GM	MG	High
GF	FG	High
GP	PG	High
GS	SG	High
GT	TG	High
GW	WG	High
GY	YG	High
GV	VG	High
HI	IH	High
HL	LH	High
HK	KH	High
HM	MH	High
HF	FH	High
HP	PH	High
HS	SH	High
HT	TH	High
HW	WH	High
HY	YH	Moderate
HV	VH	High
IL	LI	Moderate
IK	KI	High
IM	MI	Moderate
IF	FI	High
IP	PI	High
IS	SI	High
IT	TI	High
IW	WI	High
IY	YI	High
IV	VI	Moderate
LK	KL	High
LM	ML	Moderate
LF	FL	High
LP	PL	High
LS	SL	High
LT	TL	High
LW	WL	High
LY	YL	High
LV	VL	Moderate
KM	MK	High
KF	FK	High
KP	PK	High
KS	SK	High
KT	TK	High
KW	WK	High
KY	YK	High
KV	VK	High
MF	FM	High
MP	PM	High
MS	SM	High
MT	TM	High
MW	WM	High
MY	YM	High
MV	VM	Moderate
FP	PF	High
FS	SF	High
FT	TF	High
FW	WF	Moderate
FY	YF	Moderate
FV	VF	High
PS	SP	High
PT	TP	High
PW	WP	High
PY	YP	High
PV	VP	High
ST	TS	Moderate
SW	WS	High
SY	YS	High
SV	VS	High
TW	WT	High
TY	YT	High
TV	VT	High
WY	YW	Moderate
WV	VW	High
YV	VY	High